2 2 2 2 2 2 2 2 2 2 2 2 2 2 2 2 2 2 2 2 2 2 2 2 2 2 2 2 2 2
2 2 0 0 0 0 0 0 0 0 0 0 0 0 2 2 0 0 0 0 0 0 0 0 0 0 0 0 2 2
2 2 0 2 2 2 2 0 2 2 2 2 2 0 2 2 0 2 2 2 2 2 0 2 2 2 2 0 2 2
2 2 0 2 2 2 2 0 2 2 2 2 2 0 2 2 0 2 2 2 2 2 0 2 2 2 2 0 2 2
2 2 0 2 2 2 2 0 2 2 2 2 2 0 2 2 0 2 2 2 2 2 0 2 2 2 2 0 2 2
2 2 0 0 0 0 0 0 0 0 0 0 0 0 0 0 0 0 0 0 0 0 0 0 0 0 0 0 2 2
2 2 0 2 2 2 2 0 2 2 0 2 2 2 2 2 2 2 2 0 2 2 0 2 2 2 2 0 2 2
2 2 0 2 2 2 2 0 2 2 0 2 2 2 2 2 2 2 2 0 2 2 0 2 2 2 2 0 2 2
2 2 0 0 0 0 0 0 2 2 0 0 0 0 2 2 0 0 0 0 2 2 0 0 0 0 0 0 2 2
2 2 2 2 2 2 2 0 2 2 2 2 2 3 2 2 3 2 2 2 2 2 0 2 2 2 2 2 2 2
2 2 2 2 2 2 2 0 2 2 2 2 2 3 2 2 3 2 2 2 2 2 0 2 2 2 2 2 2 2
2 2 2 2 2 2 2 0 2 2 0 3 3 3 4 3 3 3 3 1 2 2 0 2 2 2 2 2 2 2
2 2 2 2 2 2 2 0 2 2 2 2 2 2 2 2 2 2 2 2 2 2 0 2 2 2 2 2 2 2
2 2 2 2 2 2 2 0 2 2 3 2 2 2 2 2 2 2 2 3 2 2 0 2 2 2 2 2 2 2
2 2 3 3 3 3 0 0 3 3 3 2 2 2 2 2 2 2 2 3 3 3 0 0 3 3 3 3 2 2
2 2 2 2 2 2 2 0 2 2 3 2 2 2 2 2 2 2 2 3 2 2 0 2 2 2 2 2 2 2
2 2 2 2 2 2 2 0 2 2 3 2 2 2 2 2 2 2 2 3 2 2 0 2 2 2 2 2 2 2
2 2 2 2 2 2 2 0 2 2 3 3 3 1 0 0 1 3 3 3 2 2 0 2 2 2 2 2 2 2
2 2 2 2 2 2 2 0 2 2 3 2 2 2 2 2 2 2 2 5 2 2 0 2 2 2 2 2 2 2
2 2 2 2 2 2 2 0 2 2 0 2 2 2 2 2 2 2 2 0 2 2 0 2 2 2 2 2 2 2
2 2 0 0 0 0 0 0 0 0 0 0 0 0 2 2 0 0 0 0 0 0 0 0 0 0 0 0 2 2
2 2 0 2 2 2 2 0 2 2 2 2 2 0 2 2 0 2 2 2 2 2 0 2 2 2 2 0 2 2
2 2 0 2 2 2 2 0 2 2 2 2 2 6 2 2 0 2 2 2 2 2 0 2 2 2 2 0 2 2
2 2 0 0 0 2 2 0 0 0 0 0 0 0 0 0 0 0 0 0 0 0 0 2 2 0 0 0 2 2
2 2 2 2 0 2 2 0 2 2 0 2 2 2 2 2 2 2 2 0 2 2 0 2 2 0 2 2 2 2
2 2 2 2 0 2 2 0 2 2 0 2 2 2 2 2 2 2 2 0 2 2 0 2 2 0 2 2 2 2
2 2 0 0 0 0 0 0 2 2 0 0 0 0 2 2 0 0 0 0 2 2 0 0 0 0 0 0 2 2
2 2 0 2 2 2 2 2 2 2 2 2 2 0 2 2 0 2 2 2 2 2 2 2 2 2 2 0 2 2
2 2 0 0 0 0 0 0 0 0 0 0 0 0 0 0 0 0 0 0 0 0 0 0 0 0 0 0 2 2
2 2 2 2 2 2 2 2 2 2 2 2 2 2 2 2 2 2 2 2 2 2 2 2 2 2 2 2 2 2